'd	MD	'd
'll	MD	'll
're	VV0	're
's	POS	's	VV0	's
've	VV0	've
,	,	,
;	:	;
?	.	?
a	AT	a
aback	RB	aback
abandon	VV0	abandon
ability	NN	ability
able	JJ	able
about	IN	about	RB	about	RP	about
above	IN	above
abroad	RB	abroad
abruptly	RB	abruptly
absence	NN	absence
absolutely	RB	absolutely
abstract	JJ	abstract
absurd	JJ	absurd
accent	NN	accent
accept	VV0	accept
acceptance	NN	acceptance
accepted	VV0	accept	VVD	accept
accepts	VV0	accept
accident	NN	accident
acclaim	NN	acclaim
acclaimed	VV0	acclaim
accommodation	NN	accommodation
account	NN	account
accuracy	NN	accuracy
accurate	JJ	accurate
accurately	RB	accurately
accusation	NN	accusation
accused	VV0	accuse
ache	NN	ache
achieve	VV0	achieve
achievements	NNS	achievement
acknowledge	VV0	acknowledge
acknowledged	VV0	acknowledge	VVD	acknowledge
acknowledgment	NN	acknowledgment
across	IN	across
act	NN	act
acted	VV0	act
action	NN	action
actor	NN	actor
address	NN	address	VV0	address
adjustments	NNS	adjustment
admirable	JJ	admirable
admiration	NN	admiration
admire	VV0	admire
admired	JJ	admired	VVD	admire
admiring	VV0	admire
admission	NN	admission
admit	VV0	admit
admits	VV0	admit
admitted	VVD	admit
adore	VV0	adore
advanced	VVD	advance
advancing	VV0	advance
adventure	NN	adventure
adventures	VV0	adventure
advice	NN	advice
advised	VVD	advise
afar	NN	afar
affirmed	VVD	affirm
affordable	JJ	affordable
afraid	JJ	afraid
after	IN	after
afternoon	NN	afternoon
afterward	RB	afterward
again	RB	again
against	IN	against
ages	NNS	age
aggressively	RB	aggressively
ago	IN	ago	RB	ago
agreed	VV0	agree	VVD	agree
agreement	NN	agreement
ahead	RB	ahead
air	NN	air
alarm	NN	alarm
alerted	VVD	alert
alibi	NN	alibi
aligned	VV0	align
all	AT	all	PDT	all	RB	all
allegation	NN	allegation
allow	VV0	allow
alluded	VVD	allude
almost	RB	almost
alone	RB	alone	VV0	alone
along	RP	along
already	RB	already
alright	JJ	alright
altered	VVD	alter
always	RB	always
am	VV0	be
amazed	VV0	amaze
amazing	JJ	amazing	VV0	amaze
amends	NNS	amends
amicably	NN	amicably
amused	VVD	amuse
amusing	VV0	amuse
an	AT	an
analysed	VVD	analyse
ancient	JJ	ancient	NN	ancient	VV0	ancient
and	CC	and
anecdote	VV0	anecdote
angered	JJ	angered	VVD	anger
angry	JJ	angry
annotated	VVD	annotate
announced	VVD	announce
announcement	NN	announcement
annoyed	VV0	annoy	VVD	annoy
annoying	VV0	annoy
another	AT	another
answer	NN	answer
answered	VV0	answer	VVD	answer
anticipated	JJ	anticipated
antique	JJ	antique	NN	antique
anxiety	NN	anxiety
anxious	JJ	anxious
any	AT	any
anymore	NN	anymore	RB	anymore	VVD	anymore
anyone	NN	anyone
anything	NN	anything
apart	RB	apart
apartment	NN	apartment
apologize	VV0	apologize
appear	VV0	appear
appeared	VVD	appear
appetizing	JJ	appetizing
application	NN	application
applications	NNS	application
applied	VVD	apply
appointment	NN	appointment
appreciate	NN	appreciate	VV0	appreciate
appreciated	VV0	appreciate	VVD	appreciate
approach	NN	approach
approaching	VV0	approach
approve	VV0	approve
architecture	NN	architecture
are	VV0	be
area	NN	area
areas	NNS	area
argue	NN	argue
argued	VVD	argue
argues	VV0	argue
argument	NN	argument
arguments	NNS	argument
aroma	NN	aroma
arose	VV0	arise
around	IN	around
arrangement	NN	arrangement
arrive	NN	arrive	VV0	arrive
arrived	VV0	arrive	VVD	arrive
arrives	VV0	arrive
art	NN	art
article	NN	article
artifact	NN	artifact
artifacts	NNS	artifact
artist	NN	artist
artwork	NN	artwork
as	IN	as	RB	as
ascent	NN	ascent
aside	RB	aside
ask	VV0	ask
assembled	VVD	assemble
asserted	VVD	assert
assertion	NN	assertion
assessment	NN	assessment
assignment	NN	assignment
assist	VV0	assist
assistance	NN	assistance
assisted	VVD	assist
assisting	VV0	assist
assume	VV0	assume
assumed	VVD	assume
assumption	NN	assumption
assurance	NN	assurance
assured	VVD	assure
asteroid	NN	asteroid
astonished	VV0	astonish
astonishing	VV0	astonish
astronaut	NN	astronaut
astronauts	NNS	astronaut
at	IN	at
ate	VV0	eat
athlete	JJ	athlete
attempt	NN	attempt
attend	VV0	attend
attended	VVD	attend
attendees	NNS	attendee
attending	VV0	attend
attention	NN	attention
attic	JJ	attic
attitude	VV0	attitude
audience	NN	audience
aunt	NN	aunt
author	NN	author
authored	VVD	author
autism	NN	autism
available	JJ	available
avenue	NN	avenue	VV0	avenue
Avenue	NN	avenue
avoid	JJ	avoid	VV0	avoid
avoided	VV0	avoid
avoiding	VV0	avoid
awake	NN	awake
award	NN	award
awards	NNS	award
award‑winning	VV0	award‑winning
aware	JJ	aware	NN	aware
awareness	NN	awareness
away	RB	away
awe-inspiring	JJ	awe-inspiring
awkward	NN	awkward
back	RB	back	RP	back	VV0	back
backfire	VV0	backfire
backfired	VVD	backfire
background	NN	background
backyard	NN	backyard
bad	JJ	bad
bag	NN	bag
bake	NN	bake
baked	VVD	bake
bakery	NN	bakery
bakes	VV0	bake
ball	NN	ball
band	NN	band
bankrupt	JJ	bankrupt
bark	NN	bark
barked	VVD	bark
barking	NN	barking	VV0	bark
based	VV0	base
baseless	JJ	baseless
basement	NN	basement
batter	NN	batter
be	VV0	be
Be	VV0	be
beanie	VV0	beanie
beautiful	JJ	beautiful
beautifully	RB	beautifully
became	VVD	become
because	IN	because
become	VV0	become
becoming	VV0	become
bed	NN	bed
been	VV0	be
beeping	VV0	beep
before	IN	before
behave	VV0	behave
behind	IN	behind
being	VV0	be
belatedly	RB	belatedly
belief	NN	belief
believable	NN	believable
believe	VV0	believe
believed	VVD	believe
believes	VV0	believe
believing	VV0	believe
bell	NN	bell
belongs	NNS	belongs	VV0	belong
beloved	VV0	beloved
below	IN	below
bench	NN	bench
beneficial	JJ	beneficial
best	JJ	best	RB	best
bestseller	NN	bestseller
betrayed	VVD	betray
better	JJ	good	RB	well
beyond	IN	beyond
biased	VV0	bias
bicycle	NN	bicycle
big	JJ	big
bike	NN	bike
bill	NN	bill
binge-watched	VVD	binge-watched
bird	NN	bird	VVD	bird
birthday	NN	birthday
bistro	NN	bistro
bit	NN	bit
bitter	NN	bitter
black	JJ	black
blackboard	NN	blackboard
blame	VV0	blame
blameless	JJ	blameless
bleed	VVD	bleed
blinking	VV0	blink
block	NN	block
blocked	VV0	block
bloomed	VVD	bloom
blooming	VV0	bloom
blouse	NN	blouse
blowing	VV0	blow
blown	VV0	blow
blue	NN	blue
blurry	JJ	blurry
board	NN	board
boiling	NN	boiling
bold	VVD	bold
bolts	NNS	bolt
book	NN	book
booked	VVD	book
books	NNS	book
boring	JJ	boring
borrowed	VVD	borrow
both	AT	both
bother	IN	bother
bothered	VV0	bother
bothersome	NN	bothersome
bottle	NN	bottle
bought	VVD	buy
bouquet	NN	bouquet
boutique	NN	boutique
bowl	NN	bowl
box	NN	box
boy	NN	boy
bracelet	NN	bracelet
branch	NN	branch
brand	NN	brand
bread	NN	bread	VVD	bread
break	NN	break	VV0	break
breaking	NN	breaking
breakup	NN	breakup
breathtaking	VV0	breathtaking
breeze	NN	breeze	VV0	breeze
brewed	VVD	brew
bridge	NN	bridge
briefing	NN	briefing
bright	JJ	bright	VVD	bright
brightly	RB	brightly
brilliant	JJ	brilliant
bring	VV0	bring
brings	VV0	bring
broken	VV0	break
brought	JJ	brought	VV0	bring	VVD	bring
budget	NN	budget
building	NN	building	VV0	build
built	VV0	build	VVD	build
bulb	NN	bulb
bumpy	NN	bumpy
burgers	NNS	burger
bus	NN	bus
business	NN	business
busy	JJ	busy	VV0	busy
but	CC	but
butterfly	NN	butterfly
buying	VV0	buy
buzzing	VV0	buzz
by	IN	by
cable	NN	cable
cafe	JJ	cafe	NN	cafe
cake	NN	cake	VV0	cake
calculations	NNS	calculation
call	NN	call	VV0	call
called	VV0	call
calling	VV0	call
calm	NN	calm
calmed	JJ	calmed	VV0	calm	VVD	calm
came	VVD	come
can	MD	can
Can	MD	can
cancel	VV0	cancel
canceled	VV0	cancel
cancelled	VV0	cancel
candle	VV0	candle
candour	NN	candour
canvas	NN	canvas
cap	NN	cap
capable	JJ	capable
cappuccino	NN	cappuccino
captivating	VV0	captivate
capture	NN	capture
captures	VV0	capture
car	NN	car
care	NN	care
cared	VVD	care
careful	JJ	careful
carelessness	NN	carelessness
caretaker	NN	caretaker
caring	VV0	care
carpet	NN	carpet
carved	VVD	carve
case	NN	case
casting	VV0	cast
castle	NN	castle
cat	NN	cat
catch	VV0	catch
catchy	JJ	catchy
caught	VV0	catch
cause	VV0	cause
caused	JJ	caused	VV0	cause	VVD	cause
cautioned	VVD	caution
celebrated	VVD	celebrate
celebration	NN	celebration
celebrity	NN	celebrity
centre	NN	centre
century	NN	century
certain	JJ	certain
chair	NN	chair
chalkboard	NN	chalkboard
challenge	NN	challenge
challenged	JJ	challenged	VVD	challenge
challenging	VV0	challenge
chance	NN	chance
change	NN	change	VV0	change
changed	VV0	change	VVD	change
changing	VV0	change
chaotic	JJ	chaotic
character	NN	character
characters	NNS	character
charge	NN	charge
charged	VV0	charge
charm	NN	charm
charming	VV0	charm
chases	VV0	chase
chat	NN	chat
cheated	VV0	cheat	VVD	cheat
check	NN	check	VV0	check
checked	VV0	check	VVD	check
cheerful	JJ	cheerful	NN	cheerful
cherish	NN	cherish	VV0	cherish
child	NN	child
childhood	NN	childhood
children	NNS	child
chilly	JJ	chilly	RB	chilly
chirping	VV0	chirp
chocolate	NN	chocolate
choice	NN	choice
chose	VV0	choose
chosen	VV0	choose
chuckled	VVD	chuckle
cinematic	JJ	cinematic
cities	NNS	city
city	NN	city
civilizations	NNS	civilization
claim	NN	claim
claimed	VVD	claim
clarification	NN	clarification
clarified	VVD	clarify
clarify	VV0	clarify
clarity	NN	clarity
class	NN	class
classic	JJ	classic	NN	classic
cleaning	NN	cleaning	VV0	clean
clear	JJ	clear	VV0	clear
clearance	NN	clearance
clearly	RB	clearly
clever	NN	clever
client	NN	client
cliff	NN	cliff
climate	NN	climate
climb	NN	climb	VV0	climb
climbed	VV0	climb
climbing	VV0	climb
clock	NN	clock
close	RB	close	VV0	close
closed	VV0	close
closure	NN	closure
cloud	JJ	cloud	NN	cloud
clouds	JJ	clouds	NN	cloud	NNS	cloud
clue	NN	clue
cluttered	VVD	clutter
coach	NN	coach
coat	NN	coat
coffee	NN	coffee
cold	JJ	cold	NN	cold	VV0	cold	VVD	cold
collaboration	NN	collaboration
collapsed	VVD	collapse
colleagues	NNS	colleague
collector	NN	collector
color	NN	color
colored	VVD	color
colorful	JJ	colorful
colors	NNS	color
colour	NNS	colour	VV0	colour
colourful	NN	colourful
colours	NN	colour
come	VV0	come
comedy	NN	comedy
comes	VV0	come
comfort	NN	comfort
comfortable	JJ	comfortable
comforted	VV0	comfort	VVD	comfort
comforting	VV0	comfort
coming	VV0	come
commented	VVD	comment
comments	NNS	comment
commitment	NN	commitment
committed	VVD	commit
common	JJ	common
communicate	VV0	communicate
communication	NN	communication
company	NN	company
compared	VV0	compare
compassion	NN	compassion
compelling	VV0	compel
compete	NN	compete
competition	NN	competition
competitive	JJ	competitive
complain	NN	complain
complained	VVD	complain
complaint	NN	complaint
complements	NNS	complement	VV0	complement
complete	JJ	complete	VV0	complete
completed	VV0	complete	VVD	complete
completely	RB	completely
complex	NN	complex
complicated	VVD	complicate
complication	NN	complication
composed	VVD	compose
computer	NN	computer
concept	NN	concept
concepts	NNS	concept
concern	NN	concern
concerned	VV0	concern
concerns	NNS	concern
concert	NN	concert
concluded	VVD	conclude
conclusion	NN	conclusion
concurred	VVD	concur
conditioner	NN	conditioner
conditions	NNS	condition
conducted	VVD	conduct
conference	NN	conference
conferences	NNS	conference
confessed	VVD	confess
confession	NN	confession
confidence	NN	confidence
confident	JJ	confident	NN	confident
confidently	RB	confidently
confirmation	NN	confirmation
confirmed	VV0	confirm	VVD	confirm
conflict	NN	conflict
confused	VVD	confuse
confusing	VV0	confuse
confusion	NN	confusion
congestion	NN	congestion
connects	VV0	connect
consented	VVD	consent
consider	VV0	consider
considered	VV0	consider
considering	VV0	consider
consistently	RB	consistently
constructed	VV0	construct	VVD	construct
construction	NN	construction
consumed	VVD	consume
contact	VV0	contact
contained	JJ	contained	VV0	contain
contemplating	VV0	contemplate
contended	VVD	contend
content	JJ	content
contest	NN	contest
contested	VVD	contest
continent	NN	continent
continue	VV0	continue
continuously	RB	continuously
contribution	NN	contribution
control	NN	control
controversial	JJ	controversial
convene	VV0	convene
convention	NN	convention
conversation	NN	conversation
convertible	JJ	convertible
conveyed	VVD	convey
conviction	NN	conviction
convince	NN	convince
convinced	VV0	convince	VVD	convince
cook	NN	cook
cooked	VVD	cook
cookie	NN	cookie
corner	NN	corner
correct	JJ	correct	NN	correct
corrected	VV0	correct
correctly	RB	correctly
corridor	NN	corridor
cosmic	JJ	cosmic
cosmos	NN	cosmos
cost	NN	cost
costly	JJ	costly
costs	NNS	cost
cosy	JJ	cosy	VV0	cosy
couch	NN	couch
could	MD	could
Could	NN	could
couldn	NN	couldn	VV0	couldn	VVD	couldn
counsel	NN	counsel
counter	NN	counter
country	NN	country
countryside	NN	countryside
course	NN	course
cousin	NN	cousin
cover	NN	cover	VV0	cover
cozy	JJ	cozy
cramped	JJ	cramped	VV0	cramp
crash	NN	crash
crashed	VV0	crash
cream	NN	cream
creamy	VV0	creamy
created	VV0	create	VVD	create
creates	VV0	create
creative	JJ	creative
creativity	NN	creativity
creator	NN	creator
credibility	NN	credibility
crime	NN	crime
critical	JJ	critical
critically	RB	critically
criticism	NN	criticism
cross	NN	cross
crossed	VV0	cross
crow	NN	crow
crowd	JJ	crowd	NN	crowd
crowded	VVD	crowd
crowing	VV0	crow
crucial	JJ	crucial
crushed	VV0	crush
cup	NN	cup	VV0	cup
cupboard	NN	cupboard
curry	NN	curry
curtain	VV0	curtain
customized	VV0	customize	VVD	customize
custom‑made	JJ	custom‑made	NN	custom‑made
cut	NN	cut	VV0	cut
cycle	NN	cycle
cycling	NN	cycling
d	JJ	d	NN	d	NNS	d	RB	d
daily	JJ	daily
damage	NN	damage
danced	VVD	dance
dancing	NN	dancing
danger	NN	danger
dangerous	JJ	dangerous
dark	NN	dark
data	NN	data
date	NN	date
dawn	NN	dawn
dawned	VV0	dawn
day	NN	day
days	NNS	day
deadline	NN	deadline
deadlines	NNS	deadline
deafening	VV0	deafen
deal	VV0	deal
dealership	NN	dealership
debatable	JJ	debatable
debate	NN	debate
debated	VV0	debate	VVD	debate
debates	NNS	debate
deceived	VV0	deceive
deceptive	JJ	deceptive
decided	VVD	decide
decision	NN	decision
decisions	NNS	decision
declaration	NN	declaration
declared	VVD	declare
decor	NN	decor
decorated	VV0	decorate	VVD	decorate
dedicated	JJ	dedicated	VV0	dedicate
deep	JJ	deep	VV0	deep
deepened	VV0	deepen
deeper	JJ	deep
deeply	RB	deeply
defence	NN	defence
defines	NNS	defines
definitely	RB	definitely
definition	NN	definition
delay	NN	delay	VV0	delay
delayed	NNS	delayed	VV0	delay	VVD	delay
delays	NNS	delay
delicate	JJ	delicate
delicious	JJ	delicious
delight	NN	delight
delightful	JJ	delightful
delivered	VV0	deliver	VVD	deliver
delivery	NN	delivery
demand	NN	demand
demanded	VVD	demand
demanding	VV0	demand
demise	NN	demise
demolishing	NN	demolishing
denial	NN	denial
denied	VVD	deny
depart	VV0	depart
depicts	VV0	depict
describe	VV0	describe
desert	NN	desert
deserved	VVD	deserve
deserves	NNS	deserves
design	NN	design
designed	VV0	design	VVD	design
designs	NNS	design
desired	VV0	desire	VVD	desire
desk	NN	desk
despite	IN	despite
dessert	NN	dessert
detailed	JJ	detailed
details	NNS	detail
detectives	NNS	detective
determination	NN	determination
determined	VVD	determine
develop	VV0	develop
did	VVD	do
Did	NN	did
didn	JJ	didn	NN	didn	RB	didn	VV0	didn
difference	NN	difference
different	JJ	different
difficult	JJ	difficult
dim	NN	dim
diminished	VV0	diminish
dimming	VV0	dim
dined	VVD	din
diner	NN	diner
dinner	NN	dinner
dinosaurs	NNS	dinosaur
directed	VVD	direct
direction	NN	direction
directions	NNS	direction
disagreed	VVD	disagree
disagreement	NN	disagreement
disappeared	VVD	disappear
disappointed	JJ	disappointed	VVD	disappoint
disclosed	VVD	disclose
disclosure	NN	disclosure
discounts	NNS	discount
discourse	NN	discourse
discovered	VVD	discover
discovery	NN	discovery
discussed	VV0	discuss	VVD	discuss
discussing	NN	discussing	VV0	discuss
discussion	NN	discussion
discussions	NNS	discussion
dish	JJ	dish	NN	dish
dishonest	JJ	dishonest	RB	dishonest
dismantling	NN	dismantling
dismissed	VV0	dismiss	VVD	dismiss
disproved	VVD	disprove
disputed	VVD	dispute
disrupted	VV0	disrupt
disruptive	VV0	disruptive
dissatisfaction	NN	dissatisfaction
distance	NN	distance
distracting	VV0	distract
distress	NN	distress
district	NN	district
disturbance	NN	disturbance
disturbed	VVD	disturb
divide	VV0	divide
divine	JJ	divine
do	VV0	do
Do	VV0	do
document	NN	document
documentary	JJ	documentary
documents	NNS	document
dodging	VV0	dodge
doesn	NN	doesn	VV0	doesn
dog	NN	dog	VV0	dog
don	VV0	don
Don	NN	don
done	VV0	do
doomed	VV0	doom
door	NN	door
doubt	NN	doubt	VV0	doubt
doubted	VVD	doubt
doubtful	JJ	doubtful	NN	doubtful
doubts	NNS	doubt
down	RB	down	RP	down
downpour	NN	downpour
downstairs	NNS	downstairs
drafted	VVD	draft
drag	NN	drag	VV0	drag
dragon	NN	dragon
dragon-shaped	JJ	dragon-shaped
drained	VV0	drain	VVD	drain
drama	NN	drama
dramatic	JJ	dramatic
drank	VVD	drink
drawer	NN	drawer
drawing	VV0	draw
drawn-out	NN	drawn-out
dread	NN	dread
dreaded	VVD	dread
dream	NN	dream
dreamed	VV0	dream
dreaming	VV0	dream
dress	NN	dress
drinks	VV0	drink
drive	NN	drive	VV0	drive
drives	VV0	drive
driveway	NN	driveway
driving	NN	driving	VV0	drive
drove	VVD	drive
due	JJ	due
dull	NN	dull
during	IN	during
eager	NN	eager
earlier	JJ	early	RB	earlier
early	JJ	early	RB	early
earned	VV0	earn
eased	JJ	eased
easier	RB	easier
easily	RB	easily
easy	VV0	easy
eat	VV0	eat
economical	JJ	economical
eco‑friendly	RB	eco‑friendly
edge	NN	edge
editing	VV0	edit
edition	NN	edition
educates	VV0	educate
education	NN	education
effective	JJ	effective
effectively	RB	effectively
efficient	JJ	efficient
effort	NN	effort
effortless	JJ	effortless	NN	effortless
efforts	NNS	effort
election	NN	election
elegant	JJ	elegant
Elm	NN	elm
else	RB	else
embarrassed	VVD	embarrass
emerged	VVD	emerge
emotion	NN	emotion
emotional	JJ	emotional
emotions	NNS	emotion
emphasized	VVD	emphasize
employees	NNS	employee
empty	VVD	empty
encounter	NN	encounter
encountered	VV0	encounter
encounters	NNS	encounter
encouraged	VV0	encourage	VVD	encourage
encourages	NNS	encourages	VV0	encourage
encouraging	JJ	encouraging	VV0	encourage
end	NN	end
ended	VVD	end
endless	JJ	endless
endure	NN	endure
energetic	JJ	energetic
energized	VVD	energize
energy	NN	energy
energy-draining	NN	energy-draining
energy‑efficient	JJ	energy‑efficient
engaged	VV0	engage
engagement	NN	engagement
engaging	VV0	engage
engine	NN	engine
enjoy	NN	enjoy	VV0	enjoy
enjoyable	JJ	enjoyable
enjoyed	VVD	enjoy
enough	JJ	enough	RB	enough
ensures	VV0	ensure
entered	VVD	enter
entertaining	VV0	entertain
enthusiasm	NN	enthusiasm
enthusiastic	JJ	enthusiastic
entrance	NN	entrance
environmentally	RB	environmentally
equally	RB	equally
equals	NNS	equal
equation	NN	equation
equipped	VV0	equip
equitable	JJ	equitable
eraser	NN	eraser
erected	VV0	erect
ergonomic	JJ	ergonomic
error	NN	error
errors	NNS	error
espresso	NN	espresso
essential	JJ	essential
evading	VV0	evade
evaluation	NN	evaluation
evening	NN	evening	VV0	even
evenings	NNS	evening
evenly	RB	evenly
event	NN	event
ever	RB	ever
Everest	NN	everest
every	AT	every
everyone	NN	everyone
everything	NN	everything
everywhere	RB	everywhere
evidence	NN	evidence
evident	JJ	evident
exactly	RB	exactly
exaggerated	VV0	exaggerate
exam	NN	exam
examine	VV0	examine
exceeded	VV0	exceed
excellent	JJ	excellent
exceptional	JJ	exceptional
exceptionally	RB	exceptionally
excessive	JJ	excessive
excited	JJ	excited	VVD	excite
exciting	JJ	exciting	VV0	excite
excuse	NN	excuse
exercise	NN	exercise
exhaust	NN	exhaust
exhausted	VVD	exhaust
exhausting	VV0	exhaust
exhibited	VVD	exhibit
exhibition	NN	exhibition
exhibits	VV0	exhibit
exists	VV0	exist
expand	NN	expand	VV0	expand
expanding	VV0	expand
expect	VV0	expect
expectation	NN	expectation
expectations	NNS	expectation
expected	VV0	expect	VVD	expect
expecting	VV0	expect
expenses	NNS	expense
expensive	JJ	expensive
experience	NN	experience
experienced	JJ	experienced
experiment	NN	experiment
expert	NN	expert
Experts	NNS	expert
explained	VVD	explain
explains	VV0	explain
explanation	NN	explanation
exploration	NN	exploration
explore	VV0	explore
explored	VV0	explore
expressed	JJ	expressed	VVD	express
expression	NN	expression
exquisite	JJ	exquisite
extended	VVD	extend
external	JJ	external
extinction	NN	extinction
extra	JJ	extra
extraordinary	JJ	extraordinary
extravagant	NN	extravagant
extremely	RB	extremely
eye	NN	eye
eye-catching	NN	eye-catching
eye-opening	JJ	eye-opening
eyeing	VV0	eye
eyes	NNS	eye
fabricated	VV0	fabricate
faced	VVD	face
facility	NN	facility
fact	NN	fact
faded	JJ	faded	VV0	fade	VVD	fade
fades	NNS	fade
fail	VV0	fail
failed	VV0	fail	VVD	fail
failure	NN	failure
fair	JJ	fair	NN	fair
fairly	RB	fairly
fairness	NN	fairness
faith	NN	faith	VV0	faith
fake	RB	fake
fall	NN	fall
fallen	VV0	fall
false	JJ	false
falsified	VVD	falsify
fame	NN	fame
families	NNS	family
family	NN	family
famous	JJ	famous
fan	NN	fan
fancy	NN	fancy
fans	NNS	fan
fantastic	JJ	fantastic
far	RB	far
far-fetched	JJ	far-fetched
farewell	RB	farewell
fascinating	VV0	fascinate
fast	JJ	fast	NN	fast	RB	fast
fasten	VV0	fasten
faster	RB	faster
fatigued	VV0	fatigue
fatiguing	VV0	fatigue
fault	NN	fault
favor	NN	favor
favorite	JJ	favorite	NN	favorite
favorites	NNS	favorite
favourite	JJ	favourite
fear	NN	fear
feared	VVD	fear
featured	JJ	featured
features	VV0	feature
fee	NN	fee
feed	VV0	fee
feedback	NN	feedback
feel	NN	feel	VV0	feel
feeling	NN	feeling	VV0	feel
feelings	NNS	feeling
feels	VV0	feel
fell	VVD	fell
fellow	NN	fellow
felt	VV0	felt	VVD	felt
fence	NN	fence
fern	JJ	fern
ferry	NN	ferry
festival	NN	festival
festive	JJ	festive
festivities	NNS	festivity
fetch	VV0	fetch
few	JJ	few
fiercely	RB	fiercely
fiery	NN	fiery
fight	VV0	fight
figure	VV0	figure
figured	VVD	figure
figures	NNS	figure
file	NN	file
files	NNS	file
filled	VV0	fill	VVD	fill
filling	NN	filling	VV0	fill
film	NN	film
filthy	NN	filthy
final	JJ	final
finals	NNS	final
financial	JJ	financial
find	VV0	find
findings	NNS	finding
fine	JJ	fine
finest	JJ	fine
finish	VV0	finish	VVD	finish
finished	VV0	finish	VVD	finish
finishing	VV0	finish
fireworks	NNS	firework
firm	NN	firm
firmly	RB	firmly
first	JJ	first	RB	first
fit	NN	fit
fits	NNS	fit	VV0	fit
fix	VV0	fix
fixed	JJ	fixed	VV0	fix	VVD	fix
Fixing	VV0	fix
fixing	VV0	fix
fixture	NN	fixture
flat	JJ	flat
flavor	NN	flavor
flavorful	JJ	flavorful
flavour	NN	flavour
flavourful	JJ	flavourful
flawed	VV0	flaw
flaws	NNS	flaw
flexibility	NN	flexibility
flickering	VV0	flicker
flight	NN	flight
floor	NN	floor
flooring	NN	flooring
flourishing	VV0	flourish
flower	NN	flower
flowerpot	NN	flowerpot
flowers	NNS	flower
flows	VV0	flow
fluent	NN	fluent
fluffy	JJ	fluffy
fluid	NN	fluid
flying	VV0	fly
focus	NN	focus
fog	NN	fog
folder	NN	folder
follow	VV0	follow
followed	VVD	follow
food	NN	food
foolish	JJ	foolish
for	IN	for
forced	JJ	forced
forceful	JJ	forceful
forcefully	RB	forcefully
forecast	NN	forecast
foresee	VV0	foresee
forest	JJ	forest	NN	forest
forever	RB	forever
forget	NN	forget	VV0	forget
forgot	VVD	forget
forgotten	VV0	forget
formation	NN	formation
forward	RB	forward
found	VV0	find	VVD	find
frame	NN	frame
frank	JJ	frank
frayed	VV0	fray
free	JJ	free
freezing	VV0	freeze
French	JJ	french
frenzy	NN	frenzy
frequent	VV0	frequent
frequently	RB	frequently
Friday	NN	friday
fridge	NN	fridge
friend	NN	friend
friendly	JJ	friendly
friends	NNS	friend	VV0	friends
frightened	VV0	frighten
from	IN	from
front	NN	front
frozen	VV0	freeze
fruit	NN	fruit
frustrated	VV0	frustrate	VVD	frustrate
frustrating	VV0	frustrate
frustration	NN	frustration
fuel‑efficient	JJ	fuel‑efficient
fulfilment	VV0	fulfilment
full	JJ	full
fully	RB	fully
fun	NN	fun
functional	JJ	functional
fundamental	JJ	fundamental
funding	NN	funding
funds	NNS	fund
funny	JJ	funny	VV0	funny
furious	JJ	furious
furniture	NN	furniture
further	JJ	further
future	NN	future
futuristic	JJ	futuristic
gaining	VV0	gain
gallery	NN	gallery
game	NN	game
gaming	NN	gaming	VV0	game
garage	NN	garage
garden	NN	garden
gasped	VVD	gasp
gate	NN	gate
gather	VV0	gather
gathering	NN	gathering
gave	VVD	give
generosity	NN	generosity
generous	JJ	generous
genetic	JJ	genetic
gesture	NN	gesture
get	NN	get	VV0	get
getaway	NN	getaway
gets	VV0	get
getting	VV0	get
gift	NN	gift
gifted	JJ	gifted
girl	NN	girl
give	VV0	give
gives	VV0	give
glass	NN	glass
gloomy	NN	gloomy
gloves	NNS	glove
glow	JJ	glow	NN	glow
glowing	VV0	glow
go	VV0	go
goal	NN	goal
goals	NNS	goal
goes	VV0	go
going	VV0	go
gone	VV0	go
good	JJ	good
goodness	NN	goodness
goods	NNS	good
gorgeous	JJ	gorgeous
gossip	NN	gossip
got	JJ	got	NNS	got	VVD	get
gotten	NNS	gotten
grab	NN	grab	VV0	grab
grabbed	VVD	grab
grades	NNS	grade
gradually	RB	gradually
grandfather	NN	grandfather
grandmother	NN	grandmother
graphic	JJ	graphic
grasp	VV0	grasp
grasped	VVD	grasp
gratitude	NN	gratitude
gray	NN	gray
great	JJ	great
grew	VVD	grow
grievance	NN	grievance
grimy	NN	grimy
ground	NN	ground
group	NN	group
grow	VV0	grow
growling	VV0	growl
growth	NN	growth
grumbled	VVD	grumble
guaranteed	VVD	guarantee
guarantees	VV0	guarantee
guard	NN	guard
guidance	NN	guidance
guided	VVD	guide
guideline	NN	guideline
guidelines	NNS	guideline
guides	VV0	guide
guilt	NN	guilt
guilty	JJ	guilty
guitar	NN	guitar
guitarist	NN	guitarist
gusts	NNS	gust
guy	NN	guy
had	VV0	have	VVD	have
hadn	VV0	hadn	VVD	hadn
hallway	NN	hallway
halted	VVD	halt
hand	NN	hand
handcrafted	VV0	handcraft
handle	NN	handle	VV0	handle
handling	NN	handling	VV0	handle
handmade	JJ	handmade
handwritten	VV0	handwritten
hang	NN	hang
hanging	VV0	hang
hangs	VV0	hang
happen	VV0	happen
happened	VVD	happen
happening	VV0	happen
happiness	NN	happiness	VV0	happiness
happy	JJ	happy
hard	JJ	hard
harder	NN	harder
harsh	JJ	harsh	NN	harsh	VV0	harsh
has	VV0	have
hasty	JJ	hasty
hat	NN	hat	PRP	hat	VV0	hat
haunted	VVD	haunt
have	VV0	have
Have	VV0	have
having	VV0	have
hazardous	JJ	hazardous
He	PRP	he
he	PRP	he
head	NN	head
headed	VVD	head
heal	VV0	heal
healing	VV0	heal
hear	VV0	hear
heard	NN	heard	VV0	hear	VVD	hear
heart	NN	heart
heartfelt	JJ	heartfelt	NN	heartfelt
hearty	NN	hearty
heat	NN	heat
heated	VVD	heat
heater	NN	heater
heavenly	RB	heavenly
heavy	JJ	heavy
heirloom	NN	heirloom
held	VV0	hold	VVD	hold
help	NN	help	VV0	help
helped	VV0	help	VVD	help
helpful	JJ	helpful
helps	NNS	help
her	NN	her	PRP	her
Her	PRP	her
here	RB	here
hero	NN	hero
herself	NN	herself	PRP	herself
hesitation	NN	hesitation
hidden	JJ	hidden	NN	hidden
hiding	NN	hiding	VV0	hide
high	JJ	high	VV0	high
high-end	NN	high-end
highlight	NN	highlight
highlighted	VVD	highlight
highly	RB	highly
highway	NN	highway
high‑performance	NN	high‑performance
hike	NN	hike	VV0	hike
hilarious	JJ	hilarious
hill	NN	hill
him	PRP	him
hinted	VVD	hint
hire	VV0	hire
His	PRP	his
his	PRP	his
Historians	NNS	historian
historic	JJ	historic
historical	JJ	historical
hit	NN	hit	VV0	hit	VVD	hit
hoax	NN	hoax
hold	VV0	hold
hold-up	JJ	hold-up	NN	hold-up
holding	VV0	hold
holds	VV0	hold
holiday	NN	holiday
home	NN	home	RB	home
honest	JJ	honest	VV0	honest
honestly	RB	honestly
honesty	NN	honesty
hoodie	NN	hoodie
hope	NN	hope	VV0	hope
hoped	VVD	hop
hopeful	JJ	hopeful
hopes	VV0	hop
hoping	VV0	hop
hopping	VV0	hop
horizon	NN	horizon
horror	NN	horror
horse	NN	horse
hosts	VV0	host
hot	JJ	hot
hotel	NN	hotel
hour	NN	hour
hours	NNS	hour
house	NN	house
houses	NNS	house
how	RB	how
hue	NN	hue
huge	JJ	huge
hum	VV0	hum
humbling	VV0	humble
hummed	VVD	hum
humor	NN	humor
humorous	JJ	humorous
humour	NN	humour
hundred	CD	hundred
hungry	JJ	hungry
hunting	VV0	hunt
hurt	VV0	hurt
hypothesis	NN	hypothesis
I	PRP	i
ice	NN	ice
icing	NN	icing
icy	NN	icy
idea	NN	idea
ideal	JJ	ideal
if	IN	if
ignore	VV0	ignore
ignored	VV0	ignore	VVD	ignore
illustrated	VVD	illustrate
imagine	NN	imagine	VV0	imagine
impact	NN	impact
impactful	JJ	impactful	NN	impactful
implausible	JJ	implausible
implemented	VV0	implement
implied	VVD	imply
importance	NN	importance
important	JJ	important
impossible	JJ	impossible
impressed	JJ	impressed
impression	NN	impression
impressive	JJ	impressive
impressively	RB	impressively
improve	VV0	improve
improvement	NN	improvement
improvements	NNS	improvement
in	IN	in
inaccessible	JJ	inaccessible
inaccurate	JJ	inaccurate
inadequate	JJ	inadequate
inattentive	JJ	inattentive
incline	NN	incline
included	VV0	include
inclusion	NN	inclusion
inconvenient	NN	inconvenient
incorrect	JJ	incorrect
increase	VV0	increase
increased	VV0	increase
incredible	JJ	incredible
incredibly	RB	incredibly
indicated	VVD	indicate
indication	NN	indication
individuals	NNS	individual
indoors	NNS	indoors
indulgent	NN	indulgent
inefficiencies	NNS	inefficiency
inevitable	JJ	inevitable
infectious	JJ	infectious
influenced	VVD	influence
information	NN	information
informative	JJ	informative
informed	VV0	inform	VVD	inform
initiative	NN	initiative
inn	NN	inn
inner	JJ	inner
innocent	JJ	innocent	NN	innocent
innovative	JJ	innovative
insightful	JJ	insightful
insights	NNS	insight
insisted	VVD	insist
insistence	NN	insistence
inspirational	JJ	inspirational
inspired	JJ	inspired
inspires	VV0	inspire
inspiring	JJ	inspiring	VV0	inspire
instant	NN	instant
instructed	VVD	instruct
instructions	NNS	instruction
instructs	VV0	instruct
insufficient	JJ	insufficient
integrity	NN	integrity
intelligence	NN	intelligence
intense	JJ	intense
intensely	RB	intensely
interconnected	VV0	interconnect
interesting	JJ	interesting	VV0	interest
intergalactic	JJ	intergalactic
intermittently	RB	intermittently
intersection	NN	intersection
interview	NN	interview
into	IN	into
intolerable	JJ	intolerable
intricate	JJ	intricate
intriguing	NN	intriguing	VV0	intrigue
invaluable	JJ	invaluable
invest	VV0	invest
investigated	VVD	investigate
involved	JJ	involved	VV0	involve	VVD	involve
involvement	NN	involvement
irrefutable	JJ	irrefutable
irreversible	JJ	irreversible
irritated	VV0	irritate
irritating	VV0	irritate
is	VV0	be
isn	NN	isn
issue	NN	issue
issues	NNS	issue
It	PRP	it
it	PRP	it
item	NN	item
its	PRP	it
jacket	NN	jacket
jackpot	NN	jackpot
jeans	NNS	jean
job	NN	job
jobs	NNS	job
jog	NN	jog	VV0	jog
jogging	VV0	jog
join	VV0	join
joke	NN	joke
jotted	VVD	jot
journey	NN	journey
joy	NN	joy
joyful	JJ	joyful	NN	joyful
judge	NN	judge
judgment	NN	judgment
juice	NN	juice
jump	NN	jump
jumping	VV0	jump
jury	NN	jury
just	RB	just
justice	NN	justice
justification	NN	justification
justified	JJ	justified
keep	VV0	keep
keeper	NN	keeper
keeping	VV0	keep
keeps	NNS	keep	VV0	keep
kept	VV0	keep	VVD	keep
key	JJ	key	NN	key
keys	NNS	key	VV0	key
kick	NN	kick
kid	NN	kid
kids	NNS	kid
kind	NN	kind
kindness	NN	kindness
knew	VVD	know
knocking	VV0	knock
know	VV0	know
knowing	VV0	know
knowledge	NN	knowledge
knowledgeable	JJ	knowledgeable
known	VV0	know
knows	VV0	know
lack	NN	lack
lacked	VVD	lack
laid	VV0	lay
lake	NN	lake
lamp	NN	lamp
landing	NN	landing
landmark	NN	landmark
landscape	NN	landscape
landscaped	JJ	landscaped
lane	NN	lane
lanes	NNS	lane
language	NN	language
languages	NNS	language
laptop	NN	laptop
large	JJ	large
large-scale	JJ	large-scale
last	JJ	last
lasting	JJ	lasting
late	JJ	late	RB	late
later	RB	later
latest	JJ	late
latte	NN	latte
laugh	IN	laugh
laughed	VVD	laugh
laughter	NN	laughter
law	NN	law
lawn	NN	lawn
lawyer	NN	lawyer
layers	NNS	layer
leader	NN	leader
leads	VV0	lead
leak	NN	leak
leaked	VV0	leak
learned	VV0	learn	VVD	learn
learner	NN	learner
learning	NN	learning	VV0	learn
leased	VVD	lease
leave	VV0	leave
leaving	VV0	leave
lecture	NN	lecture
led	VV0	lead	VVD	lead
leeway	NN	leeway
left	VV0	leave	VVD	leave
lent	VV0	lend
lessens	VV0	lessen
lesson	NN	lesson
let	VV0	let	VVD	let
Let	VV0	let
letter	NN	letter
library	NN	library
lid	NN	lid	VVD	lid
lie	NN	lie
lied	VV0	lie
life	NN	life
lifelong	JJ	lifelong
lift	NN	lift
lifted	JJ	lifted	VV0	lift	VVD	lift
light	JJ	light	NN	light
like	IN	like	VV0	like
liking	NN	liking
limited	JJ	limited
line	NN	line
lingered	VVD	linger
list	NN	list
listened	VVD	listen
little	JJ	little
live	JJ	live
lively	RB	lively
lives	NNS	life	VV0	live
ll	JJ	ll
loaf	NN	loaf
local	JJ	local
located	VV0	locate
lock	VV0	lock
lodged	VVD	lodge
logic	NN	logic
long	JJ	long	RB	long
longer	JJ	long
longing	VV0	long
look	NN	look	VV0	look
looked	VVD	look
looking	VV0	look
looks	NNS	look	VV0	look
loose	JJ	loose
lose	VV0	lose
losing	VV0	lose
lost	VV0	lose	VVD	lose
lot	NN	lot
lottery	NN	lottery
loud	NN	loud	VV0	loud
loudly	RB	loudly
love	NN	love	VV0	love
loved	VV0	love
lovely	JJ	lovely	RB	lovely
low	JJ	low
lower	JJ	low
loyal	JJ	loyal
luck	NN	luck	VVD	luck
lunch	NN	lunch
luxurious	JJ	luxurious
luxury	NN	luxury
lying	NN	lying
m	JJ	m	MD	m	NNS	m	RB	m
made	VV0	make	VVD	make
magazine	NN	magazine
magnificent	JJ	magnificent
mailed	VVD	mail
Main	NN	main
maintained	VVD	maintain
maintenance	NN	maintenance	VV0	maintenance
majestic	JJ	majestic
major	JJ	major
make	VV0	make
makes	VV0	make
making	VV0	make
malfunctioning	VV0	malfunction
mall	NN	mall
man	NN	man
manage	VV0	manage
manager	NN	manager
manages	VV0	manage
manner	NN	manner
manuscript	NN	manuscript
many	JJ	many
marathon	NN	marathon
marker	NN	marker
market	NN	market
Market	NN	market
markets	NNS	market
married	JJ	married	VV0	marry
marry	VV0	marry
massive	JJ	massive
masterpiece	NN	masterpiece
mat	NN	mat
match	NN	match
matches	VV0	match
material	JJ	material
math	NN	math
matter	NN	matter
mattered	VV0	matter
matters	NNS	matter
maturely	RB	maturely
maturity	NN	maturity
me	PRP	me
meal	NN	meal
measures	NNS	measure
medicine	NN	medicine
meet	NN	meet	VV0	meet
meeting	NN	meeting
melodic	VVD	melodic
melody	NN	melody
members	NNS	member
memorable	JJ	memorable
memories	NNS	memory
memory	NN	memory
mend	VV0	mend
mended	VV0	mend
mentioned	VV0	mention	VVD	mention
mentor	NN	mentor
mentors	NNS	mentor	VV0	mentor
meow	NN	meow
meowing	VV0	meow
merging	VV0	merge
mesmerizing	VV0	mesmerize
message	NN	message
messy	NN	messy
met	VV0	meet	VVD	meet
method	NN	method
methods	NNS	method
middle	NN	middle
midnight	NN	midnight
might	MD	might
mileage	NN	mileage
mind	NN	mind
mind-blowing	JJ	mind-blowing
minutes	NNS	minute
miscalculated	VVD	miscalculate
misguided	VV0	misguide
misjudged	VVD	misjudge
misleading	VV0	mislead
misled	VV0	mislead	VVD	mislead
misplaced	VV0	misplace
miss	VV0	miss
missed	VV0	miss	VVD	miss
missing	VV0	miss
mistake	NN	mistake	VV0	mistake
mistaken	VV0	mistake
mistakes	NNS	mistake
mistrust	NN	mistrust
misunderstood	VVD	misunderstand
model	NN	model
modern	JJ	modern
modified	VV0	modify
moist	JJ	moist
moment	NN	moment
money	NN	money
month	NN	month
months	NNS	month
monument	JJ	monument	NN	monument
moon	NN	moon
more	JJ	more	RB	more
morning	NN	morning
most	RB	most
motion	NN	motion
motivated	VV0	motivate	VVD	motivate
motivates	VV0	motivate
motivating	VV0	motivate
motor	NN	motor
motorcycle	NN	motorcycle
Mount	NN	mount
mountain	NN	mountain
mousse	NN	mousse
mouthwatering	VV0	mouthwatering
move	NN	move	VV0	move
moved	VV0	move	VVD	move
movement	NN	movement
movie	NN	movie
moving	VV0	move
much	JJ	much	RB	much
mug	NN	mug
mural	JJ	mural	NN	mural
museum	NN	museum
music	NN	music
musician	NN	musician
must	MD	must
My	PRP	my
my	PRP	my
myself	PRP	myself
mystery	NN	mystery
n't	RB	n't
name	NN	name
narrated	VVD	narrate
narrative	JJ	narrative
narrow	JJ	narrow
natural	JJ	natural
naïve	JJ	naïve
near	IN	near
necessary	JJ	necessary
necklace	NN	necklace
need	NN	need	VV0	need
needed	VV0	need	VVD	need
needs	NNS	need	VV0	need
neglecting	VV0	neglect
negligent	JJ	negligent
negotiators	NNS	negotiator
neighbor	NN	neighbor
neighborhood	NN	neighborhood
neighbour	NN	neighbour
neighing	VV0	neigh
nervous	JJ	nervous
never	RB	never
new	JJ	new
newly	RB	newly
news	NN	news
next	IN	next	JJ	next
nice	JJ	nice
night	NN	night
no	AT	no	RB	no
nobody	NN	nobody
noise	NN	noise
noisy	JJ	noisy
non-negotiable	JJ	non-negotiable
non-stop	JJ	non-stop
nonstop	JJ	nonstop
not	RB	not
notebook	NN	notebook
noted	VVD	note
notes	NNS	note
nothing	NN	nothing
notice	VV0	notice
noticed	VVD	notice
notion	NN	notion
novel	JJ	novel	NN	novel
now	RB	now
numerous	JJ	numerous
Oak	NN	oak
objected	VVD	object
objection	NN	objection
objections	NNS	objection
observe	VV0	observe
observed	VVD	observe
observing	VV0	observe
obsolete	JJ	obsolete
obstacles	NNS	obstacle
obvious	JJ	obvious
occupies	VV0	occupy
ocean	NN	ocean
odd	JJ	odd
of	IN	of
off	IN	off	RB	off	RP	off
offended	VVD	offend
offered	VVD	offer
offering	VV0	offer
offers	VV0	offer
office	NN	office
often	RB	often
okay	JJ	okay	NN	okay
old	JJ	old
on	IN	on
once	RB	once
one	CD	one	NN	one
online	NN	online
only	RB	only
open	JJ	open
opened	JJ	opened
openness	NN	openness
operates	VV0	operate
operating	VV0	operate
operational	JJ	operational
opinion	NN	opinion
opposed	VVD	oppose
optimism	NN	optimism
optimistic	JJ	optimistic
option	NN	option
orchard	NN	orchard
order	NN	order
ordered	VVD	order
orders	NNS	order
organized	VVD	organize
original	JJ	original
originating	VV0	originate
other	JJ	other
others	NNS	others
our	PRP	our
ours	JJ	ours	VV0	ours
out	IN	out	RB	out	RP	out
outcome	NN	outcome
outdated	VV0	outdated	VVD	outdated
outfit	JJ	outfit
outside	IN	outside	JJ	outside
outstanding	JJ	outstanding
oven	NN	oven
over	IN	over	RP	over
overcast	NN	overcast
overcomes	RB	overcomes
overdue	JJ	overdue
overlooked	VVD	overlook
overlooks	VV0	overlook
overpass	NN	overpass
overpowering	VV0	overpower
overpriced	VV0	overprice
oversized	VV0	oversized
overwhelmed	VVD	overwhelm
overwhelming	VV0	overwhelm
owl	RB	owl
own	JJ	own	VV0	own
owned	VV0	own	VVD	own
owner	NN	owner
owns	VV0	own
pace	NN	pace
package	NN	package
packed	JJ	packed	VVD	pack
page	NN	page
pager	NN	pager
paid	VV0	pay	VVD	pay
pain	NN	pain
painful	JJ	painful
paint	NN	paint
painted	VV0	paint	VVD	paint
painting	NN	painting	VV0	paint
pair	NN	pair
palace	NN	palace
panic	JJ	panic	NN	panic
paper	NN	paper
parents	NNS	parent
park	NN	park
parked	VV0	park	VVD	park
parking	NN	parking	VV0	park
parrot	NN	parrot
part	NN	part
participate	NN	participate	VV0	participate
participation	NN	participation
party	NN	party
pass	VV0	pass
passed	VV0	pass	VVD	pass
passengers	NNS	passenger
passion	NN	passion
passionate	NN	passionate
passionately	RB	passionately
past	IN	past
pastry	NN	pastry
path	NN	path
paths	NNS	path
pathway	NN	pathway
patience	NN	patience
patient	JJ	patient	NN	patient
patiently	RB	patiently
patisserie	NN	patisserie
patrons	NNS	patron
pattern	NN	pattern
pause	VV0	pause
pay	VV0	pay
payment	NN	payment
pays	NNS	pay
peace	NN	peace
peaceful	JJ	peaceful	NN	peaceful
peacefully	RB	peacefully
peak	NN	peak
pen	NN	pen	VV0	pen
pencil	NN	pencil
pendant	NN	pendant
penned	VVD	pen
people	NNS	people
perception	NN	perception
perched	VV0	perch
perfect	JJ	perfect
perfection	NN	perfection
perfectly	RB	perfectly
perform	NN	perform
performance	NN	performance
performed	VVD	perform
performing	VV0	perform
performs	NNS	performs	VV0	perform
perfume	VV0	perfume
perseverance	NN	perseverance
persistence	NN	persistence
person	NN	person
persuade	VV0	persuade	VVD	persuade
persuasive	JJ	persuasive
pet	NN	pet
petting	NN	petting
phone	NN	phone
photo	NN	photo
photograph	NN	photograph
phrase	NN	phrase
physics	NNS	physic
piano	NN	piano
pick	NN	pick	VV0	pick
picked	VVD	pick
picture	NN	picture
pie	NN	pie
pigment	NN	pigment
Pine	NN	pine
pink	NN	pink
pipe	NN	pipe
pitch-black	NN	pitch-black
pivotal	JJ	pivotal
pizza	NN	pizza
pizzeria	NN	pizzeria
place	NN	place	VV0	place
placed	VVD	place
plagiarized	VV0	plagiarize
plan	NN	plan
planned	VV0	plan	VVD	plan
planning	VV0	plan
plans	NNS	plan
plant	NN	plant
planted	VVD	plant
play	NN	play	VV0	play
played	VVD	play
players	NNS	player
playful	JJ	playful
playing	VV0	play
plays	VV0	play
pleasant	JJ	pleasant
Please	NN	please	VV0	please
pleased	JJ	pleased
plot	NN	plot
podcast	NN	podcast
point	NN	point
pointed	VVD	point
pointless	NN	pointless
policies	NNS	policy
policy	NN	policy
polluted	VV0	pollute
pond	NN	pond
pool	NN	pool
poor	JJ	poor
popular	JJ	popular
popularity	NN	popularity
porch	NN	porch
portion	NN	portion
portrait	NN	portrait
pose	VV0	pose
positioned	VVD	position
possessed	VVD	possess
possibility	NN	possibility
possible	JJ	possible
post	NN	post
postponed	VV0	postpone
pot	NN	pot
power	NN	power
powerful	JJ	powerful
practical	JJ	practical
practice	NN	practice
praise	NN	praise
praised	VVD	praise
praising	NN	praising
prank	NN	prank
prayed	VV0	pray	VVD	pray
precious	JJ	precious
precisely	RB	precisely
precision	NN	precision
predict	VV0	predict
predicted	VVD	predict
prefer	VV0	prefer
prefers	VV0	prefer
premiered	VVD	premier
preparations	NNS	preparation
prepared	JJ	prepared	VV0	prepare	VVD	prepare
preparing	VV0	prepare
presence	NN	presence
present	JJ	present	VVD	present
presentation	NN	presentation
presented	VVD	present
press	NN	press
pressing	VV0	press
pressure	NN	pressure
presume	VV0	presume
presumed	VVD	presume
presumption	NN	presumption
prevail	VV0	prevail
prevails	NNS	prevails
priceless	JJ	priceless
pricey	NN	pricey
primary	JJ	primary
primitive	JJ	primitive
prior	JJ	prior
prioritized	VV0	prioritize
pristine	NN	pristine
prize	NN	prize
problem	NN	problem
problematic	JJ	problematic
problems	NNS	problem
procedures	NNS	procedure
proceed	VV0	proceed
process	NN	process
processed	VV0	process
processes	VV0	process
processor	NN	processor
proclaimed	VVD	proclaim
produces	VV0	produce
product	NN	product
professor	NN	professor
proficient	NN	proficient
program	NN	program
programming	VV0	program
progress	NN	progress
progressing	VV0	progress
project	NN	project
promised	VVD	promise
promising	VV0	promise
promotion	NN	promotion
promptly	RB	promptly
pronunciation	NN	pronunciation
proof	NN	proof
properly	RB	properly
property	NN	property
proposal	NN	proposal
proposed	VVD	propose
protecting	VV0	protect
protested	VVD	protest
proved	JJ	proved	VV0	prove	VVD	prove
provided	VVD	provide
prowls	VV0	prowl
published	VVD	publish
punchline	NN	punchline
puppy	JJ	puppy	NN	puppy
purchase	NN	purchase
purchased	VVD	purchase
pure	NN	pure
purely	RB	purely
purpose	NN	purpose
purse	NN	purse
push	NN	push
pushed	VV0	push	VVD	push
put	VV0	put	VVD	put
putting	VV0	put
puzzle	NN	puzzle
puzzling	VV0	puzzle
qualified	JJ	qualified
quality	NN	quality
question	NN	question	VV0	question
questionable	JJ	questionable
questioned	VV0	question	VVD	question
questions	NNS	question
quick	VV0	quick
quickly	RB	quickly
quiet	JJ	quiet
quit	VV0	quit
quite	RB	quite
quitting	VV0	quit
quiz	NN	quiz
rabbit	NN	rabbit
raccoon	NN	raccoon
race	NN	race
radio	NN	radio
rain	NN	rain	VV0	rain
rained	VVD	rain
rainfall	NN	rainfall
raised	JJ	raised	VV0	raise
rapidly	RB	rapidly
rare	JJ	rare
rate	NN	rate
ratings	NNS	rating
raving	VV0	rave
re	JJ	re	VV0	re
reach	NN	reach	VV0	reach
reached	VVD	reach
read	NN	read	VV0	read	VVD	read
reading	NN	reading
reads	VV0	read
real	JJ	real
reality	NN	reality
realization	NN	realization
realize	NN	realize	VV0	realize
realized	VVD	realize
realizes	VV0	realize
really	RB	really
reason	NN	reason
reasonable	JJ	reasonable
reasoning	NN	reasoning
reassured	JJ	reassured	VV0	reassure	VVD	reassure
reassuring	VV0	reassure
rebutted	VVD	rebut
recall	VV0	recall
recalled	VVD	recall
recalling	NN	recalling
received	JJ	received	VV0	receive	VVD	receive
recently	RB	recently
recipe	NN	recipe
reckless	JJ	reckless	NN	reckless
recklessly	RB	recklessly
recognition	NN	recognition
recognize	VV0	recognize
recognized	VV0	recognize	VVD	recognize
recognizes	VV0	recognize
recollect	VV0	recollect
recollection	NN	recollection
recommendation	NN	recommendation
recommended	VVD	recommend
recommending	VV0	recommend
reconcile	VV0	reconcile
recorded	VVD	record
records	NNS	record
recover	VV0	recover
red	JJ	red
reddish	JJ	reddish
redo	VV0	redo
reflective	VV0	reflective
refreshing	VV0	refresh
refrigerator	NN	refrigerator
refusal	NN	refusal
refused	VVD	refuse
refutation	NN	refutation
refuted	VVD	refute
regret	NN	regret
regulation	NN	regulation
regulations	NNS	regulation
reiterated	VVD	reiterate
rejected	VVD	reject
rejection	NN	rejection
relationship	NN	relationship
relax	VV0	relax
relaxing	VV0	relax
relentless	NN	relentless
reliable	JJ	reliable	NN	reliable
relief	NN	relief
relieved	VVD	relieve
relocating	VV0	relocate
reluctant	JJ	reluctant
remained	VV0	remain
remark	NN	remark
remarkable	JJ	remarkable
remarked	VVD	remark
remember	VV0	remember
remembered	VVD	remember
reminded	VVD	remind
reminds	VV0	remind
reminiscing	VV0	reminisce
remorse	NN	remorse
renovated	VV0	renovate
renovating	VV0	renovate
renovation	NN	renovation
rented	VVD	rent
repair	NN	repair	VV0	repair
repaired	VV0	repair	VVD	repair
repairs	NNS	repair
repeating	VV0	repeat
replaced	VV0	replace
replacement	NN	replacement
reply	NN	reply
report	NN	report
reported	VVD	report
represent	VV0	represent
request	NN	request
require	VV0	require
required	VVD	require
requires	VV0	require
research	NN	research
Researchers	NNS	researcher
reserved	VV0	reserve
residences	NNS	residence
resignation	NN	resignation
resigning	VV0	resign
resistance	NN	resistance
resolution	NN	resolution
resolve	VV0	resolve
resolved	VV0	resolve
resonated	VV0	resonate
resort	NN	resort
respect	NN	respect	VV0	respect
respected	VV0	respect	VVD	respect
respond	VV0	respond
response	NN	response
responsibility	NN	responsibility
responsible	JJ	responsible
responsibly	RB	responsibly
rest	NN	rest
restaurant	NN	restaurant
rested	VVD	rest
resting	VV0	rest
restored	VVD	restore
restriction	NN	restriction
restrictive	JJ	restrictive
resulted	VV0	result	VVD	result
results	NNS	result
retired	JJ	retired
retiring	VV0	retire
return	NN	return	VV0	return
returned	VV0	return
returning	VV0	return
reunite	VV0	reunite
revealed	VVD	reveal
revelation	NN	revelation
review	NN	review	VV0	review
reviews	NNS	review
revised	VV0	revise
revision	NN	revision
revolutionized	JJ	revolutionized
reward	NN	reward
rewarding	VV0	reward
rework	NN	rework
rich	JJ	rich	VV0	rich
riddle	JJ	riddle
ride	NN	ride
rides	VV0	rid
ridiculous	JJ	ridiculous
right	JJ	right	NN	right	RB	right
ring	VV0	ring
ringing	VV0	ring
ripe	NN	ripe
ripping	VV0	rip
rise	NN	rise
risky	JJ	risky
river	NN	river
riverbank	NN	riverbank
road	NN	road
roast	NN	roast
rocky	VV0	rocky
role	NN	role
rooftop	NN	rooftop
room	NN	room
rooster	NN	rooster
rough	NN	rough
route	NN	route
rowdy	VV0	rowdy
rug	NN	rug
ruined	VV0	ruin
rule	NN	rule
rules	NNS	rule
ruling	NN	ruling
rumour	NN	rumour
run	NN	run	VV0	run
running	VV0	run
runs	NNS	run	VV0	run
rush	JJ	rush
s	JJ	s	NN	s	NNS	s	PRP	s	RB	s	VV0	s	VVD	s
saddened	VV0	sadden
safe	JJ	safe
safety	NN	safety
said	VVD	say
sale	NN	sale
salty	JJ	salty	NN	salty
same	JJ	same
sandwich	JJ	sandwich	NN	sandwich
sandwiches	NNS	sandwich
sang	VV0	sing	VVD	sing
sat	VVD	sit
satisfaction	NN	satisfaction
satisfied	VV0	satisfy
satisfying	VV0	satisfy
sauce	NN	sauce
saw	VVD	saw
say	VV0	say
scalding	VV0	scald
scale	NN	scale	VV0	scale
scandal	NN	scandal
scared	VV0	scar
scarf	JJ	scarf	NN	scarf
scene	NN	scene
scenic	JJ	scenic
sceptical	JJ	sceptical
schedule	NN	schedule
scheduled	JJ	scheduled	VVD	schedule
scheming	VV0	scheme
Scholars	NNS	scholar
school	NN	school
science	NN	science
scientific	JJ	scientific
scientist	NN	scientist
Scientists	NNS	scientist
scooter	NN	scooter
scorching	VV0	scorch
screen	NN	screen
screwdriver	NN	screwdriver
scribbled	VVD	scribble
scrumptious	JJ	scrumptious
scrutinized	VVD	scrutinize
sculpture	NN	sculpture
sea	NN	sea
seafood	NN	seafood
seal	NN	seal
sealed	VVD	seal
seamless	JJ	seamless
searching	VV0	search
seasoning	VV0	season
seated	VV0	seat
seating	NN	seating
second	JJ	second
second-hand	NN	second-hand
secret	JJ	secret
secrets	NNS	secret
secure	JJ	secure	VV0	secure
security	NN	security
see	VV0	see
seeing	VV0	see
seeking	VV0	seek
seem	VV0	seem
seemed	VVD	seem
seems	VV0	seem
seen	VV0	see
selected	VV0	select
self-assured	JJ	self-assured
seminar	NN	seminar
sense	NN	sense	VV0	sense
sensitive	JJ	sensitive
sent	VV0	send	VVD	send
sentence	NN	sentence
sentences	NNS	sentence
sentimental	VV0	sentimental
serene	JJ	serene
series	NN	series
serious	JJ	serious
served	VVD	serve
server	NN	server
serves	VV0	serve
service	NN	service
session	NN	session
set	VV0	set
setbacks	NNS	setback
settle	VV0	settle
settled	VV0	settle
several	JJ	several
severe	VVD	severe
shade	NN	shade	VVD	shade
shadowy	NN	shadowy
shallow	JJ	shallow	NN	shallow
shape	NN	shape
shaped	VVD	shape
shared	VVD	share
sharing	VV0	share
sharp	JJ	sharp
shattered	VV0	shatter
She	PRP	she
she	PRP	she
shelf	NN	shelf
shifting	VV0	shift
shining	VV0	shin
shipment	NN	shipment
shirt	NN	shirt	VV0	shirt
shock	NN	shock	VV0	shock
shocked	VV0	shock
shocking	VV0	shock
shoes	NNS	shoe
shoot	NN	shoot
shop	NN	shop
shopping	NN	shopping
shore	NN	shore
short	JJ	short
shot	NN	shot
should	MD	should
show	NN	show	VV0	show
showcased	VVD	showcased
showed	JJ	showed	VVD	show
showing	NN	showing
shown	VV0	show
showroom	NN	showroom
shut	VV0	shut
shutdown	NN	shutdown
shutter	NN	shutter
shutting	VV0	shut
side	NN	side
sign	NN	sign
signal	NN	signal
signed	VV0	sign
significant	JJ	significant
simple	JJ	simple
simplistic	JJ	simplistic
simply	RB	simply
since	IN	since
sincere	JJ	sincere
sincerity	NN	sincerity
sing	VV0	sing
singing	NN	singing
sings	VV0	sing
sip	NN	sip
sit	VV0	sit
site	NN	site
sits	VV0	sit
sitting	VV0	sit
situation	NN	situation
skill	NN	skill
skilled	JJ	skilled
skillful	JJ	skillful
skills	NNS	skill
skirt	NN	skirt
sky	NN	sky
skyscraper	NN	skyscraper
sleek	JJ	sleek
sleepy	NN	sleepy
slip	VV0	slip
slippery	JJ	slippery
slipping	VV0	slip
slope	NN	slope
slow	JJ	slow	VV0	slow
slowly	RB	slowly
small	JJ	small
smells	NNS	smell	VV0	smell
smile	JJ	smile	NN	smile	VV0	smile
smiling	VV0	smile
smooth	NN	smooth
smoothly	RB	smoothly	VV0	smoothly
so	RB	so
soda	NN	soda
sofa	NN	sofa
soften	VVD	soften
software	NN	software
sold	VV0	sell
solution	NN	solution
solve	VV0	solve
solves	NNS	solves
some	AT	some
someday	NN	someday	RB	someday
someone	NN	someone
something	NN	something
sometime	RB	sometime
song	NN	song
soon	RB	soon
sooner	NN	sooner
soothing	VV0	soothe
sorbet	NN	sorbet
sorrow	NN	sorrow
sorting	VV0	sort
sound	NN	sound
sounds	NNS	sound	VV0	sound
soup	NN	soup
sour	NN	sour
space	NN	space
space-themed	JJ	space-themed
spacious	JJ	spacious
spanner	NN	spanner
sparked	JJ	sparked	VVD	spark
sparkling	VV0	sparkle
speak	NN	speak
speaker	NN	speaker
speaking	NN	speaking
special	JJ	special
spectacular	JJ	spectacular
spectators	NNS	spectator
speculation	NN	speculation
speech	NN	speech
speed	NN	speed
spend	JJ	spend	VV0	spend
spent	VVD	spend
spicy	JJ	spicy	NN	spicy
spine-chilling	NN	spine-chilling
spirits	NNS	spirit
spoke	VVD	speak
spoken	VV0	speak
spokesperson	NN	spokesperson
sports	NNS	sport
spot	NN	spot	VV0	spot
spread	NN	spread
spree	NN	spree
spring	NN	spring
square	NN	square
squawking	VV0	squawk
squirrel	NN	squirrel	VVD	squirrel
stabilizing	VV0	stabilize
stadium	NN	stadium
staff	NN	staff
stage	NN	stage
staged	VV0	stag
stained	VV0	stain	VVD	stain
stalled	JJ	stalled
stand	NN	stand	VV0	stand
standard	NN	standard	VV0	standard
standards	NNS	standard
stands	VV0	stand
star	NN	star
staring	VV0	star
starred	VVD	star
start	VV0	start
started	VVD	start
starting	VV0	start
startled	VV0	startle
stated	VVD	state
statement	NN	statement
state‑of‑the‑art	JJ	state‑of‑the‑art
station	NN	station
stay	NN	stay	VV0	stay
stayed	VV0	stay	VVD	stay
staying	VV0	stay
steaming	VV0	steam
steep	JJ	steep	VV0	steep
steering	VV0	steer
step	VV0	step
stepping	VV0	step
stick	NN	stick
stifling	VV0	stifle
still	RB	still
sting	VV0	sting
stir	NN	stir
stole	VVD	steal
stolen	VV0	steal
stood	VVD	stand
stop	NN	stop	VV0	stop
stopped	VV0	stop
stops	VV0	stop
store	NN	store
stores	NNS	store
storm	NN	storm
story	NN	story
straight	VVD	straight
straightforward	NN	straightforward
strange	JJ	strange
strategy	NN	strategy
stream	NN	stream
street	NN	street
Street	NN	street
streets	NNS	street
strength	NN	strength
strenuous	JJ	strenuous
stressed	VVD	stress
stressful	NN	stressful
stricter	NN	stricter
striking	VV0	strike
stroll	VV0	stroll
strolled	VVD	stroll
strong	JJ	strong
strongly	RB	strongly
structure	NN	structure
struggling	VV0	struggle
stuck	VV0	stick
student	NN	student
students	NNS	student
studied	VV0	study
studies	NNS	study
studio	NN	studio
studying	VV0	study
stunned	VV0	stun	VVD	stun
stunning	JJ	stunning	VV0	stun
sturdy	JJ	sturdy
style	NN	style
stylish	JJ	stylish
subject	JJ	subject	NN	subject
subjective	JJ	subjective
submission	NN	submission
submit	VV0	submit
submitted	VV0	submit
subtle	JJ	subtle
succeed	VV0	succeed
succeeded	VV0	succeed
success	NN	success
successful	JJ	successful
successfully	RB	successfully
such	JJ	such	PDT	such
suffer	VV0	suffer
suffering	VV0	suffer
suffocating	VV0	suffocate
suggested	VVD	suggest
suggestion	NN	suggestion
suits	NNS	suit
summer	NN	summer
summers	NNS	summer
summiting	VV0	summit
sun	NN	sun
Sunday	NN	sunday
sunrise	NN	sunrise
sunset	NN	sunset
support	NN	support	VV0	support
supported	VV0	support
supporters	NNS	supporter
supportive	JJ	supportive
supports	VV0	support
supposed	VV0	suppose
sure	JJ	sure	NN	sure	RB	sure	VV0	sure
surface	NN	surface
surprised	JJ	surprised	VV0	surprise	VVD	surprise
surprises	NNS	surprise
surprising	JJ	surprising	VV0	surprise
surrounded	VV0	surround
surroundings	NNS	surroundings
surrounds	VV0	surround
surveillance	NN	surveillance
suspect	NN	suspect	VV0	suspect
suspects	VV0	suspect
suspense	NN	suspense
suspicion	NN	suspicion
suspicions	NNS	suspicion
suspicious	JJ	suspicious
sustained	VV0	sustain
swallow	VV0	swallow
sweater	NN	sweater
sweet	JJ	sweet	NN	sweet
sweltering	VV0	swelter
swiftly	RB	swiftly
swim	NN	swim
switch	NN	switch	VV0	switch
swore	VVD	swear
symposium	NN	symposium
system	NN	system
t	IN	t	JJ	t	NN	t	NNS	t	RB	t	VV0	t	VVD	t	WDT	t
table	NN	table
take	VV0	take
taken	VV0	take
takes	VV0	take
tale	NN	tale	VV0	tale
talent	NN	talent
talented	VV0	talented
talk	NN	talk	VV0	talk
talked	VVD	talk
talking	VV0	talk
tall	JJ	tall	NN	tall
tangy	NN	tangy
task	NN	task
tasks	NNS	task
taste	NN	taste
tasted	JJ	tasted	VVD	taste
tasty	JJ	tasty
taught	VVD	teach
taxes	NNS	tax
tea	NN	tea
teacher	NN	teacher
teaches	VV0	teach
teaching	VV0	teach
team	NN	team
teammate	NN	teammate
teamwork	NN	teamwork
tearing	VV0	tear
technology	NN	technology
tedious	JJ	tedious
tell	VV0	tell
telling	VV0	tell
temperature	NN	temperature
tend	VV0	tend
tended	VVD	tend
tension	NN	tension	VV0	tension
term	NN	term
terms	NNS	term
terrain	NN	terrain
terrified	VV0	terrify
terrifying	VV0	terrify
test	NN	test
testified	VVD	testify
testimonials	NNS	testimonial
testimony	NN	testimony
texture	NN	texture
than	IN	than
that	CJT	that	CST	that	DD1	that	RA	that	WPR	that
That	DD1	that
the	AT	the
The	AT	the
theater	NN	theater
Their	PRP	their
their	PRP	their
them	PRP	them
themselves	PRP	themselves
theory	NN	theory
there	EX	there	RB	there
They	PRP	they
they	PRP	they
thick	NN	thick
thing	NN	thing
things	NNS	thing
think	NN	think	VV0	think
thinking	NN	thinking	VV0	think
thinks	VV0	think
this	AT	this
thought	NN	thought	VVD	think
thoughtful	JJ	thoughtful
thoughts	NNS	thought
thought‑provoking	VV0	thought‑provoking
thrift	NN	thrift
thrill	NN	thrill
thrilled	VVD	thrill
thriller	NN	thriller
thrilling	VV0	thrill
through	IN	through	RP	through
thunder	NN	thunder
thunderstorm	NN	thunderstorm
tidying	VV0	tidy
tight	JJ	tight
tighten	VV0	tighten
tightly	RB	tightly
time	NN	time
time-consuming	NN	time-consuming
timeless	JJ	timeless
times	NNS	time
tint	NN	tint
tip	NN	tip
tiring	VV0	tire
to	TO	to
toasty	VV0	toasty
today	NN	today
together	RB	together
told	VV0	tell	VVD	tell
tomorrow	NN	tomorrow
tone	NN	tone
tonight	NN	tonight
too	RB	too
took	VVD	take
tool	NN	tool
top	JJ	top	NN	top
topic	NN	topic
top‑notch	JJ	top‑notch
tormented	VV0	torment
torn	JJ	torn
touch	JJ	touch
touched	JJ	touched	VV0	touch
tough	JJ	tough
tour	NN	tour	VV0	tour
toured	VVD	tour
tournament	NN	tournament
tower	NN	tower
towers	NNS	tower
town	NN	town
track	NN	track
traditional	JJ	traditional
trail	NN	trail	VV0	trail
trails	NNS	trail
train	NN	train
training	NN	training
trains	VV0	train
tram	NN	tram
transaction	NN	transaction
transformed	VVD	transform
translated	VV0	translate	VVD	translate
transparency	NN	transparency
transparent	NN	transparent
transparently	RB	transparently
trapped	VV0	trap
travel	NN	travel	VV0	travel
traveled	VVD	travel
traveling	VV0	travel
travellers	NNS	traveller
treacherous	JJ	treacherous
treated	VV0	treat
tree	NN	tree
trees	NNS	tree
trek	NN	trek
trekked	VVD	trek
trending	VV0	trend
tricky	JJ	tricky	VV0	tricky
tried	VVD	try
triggered	VVD	trigger
trip	NN	trip
triumph	VV0	triumph
truck	NN	truck
true	JJ	true
trust	NN	trust	VV0	trust
trusted	VVD	trust
trusts	VV0	trust
truth	NN	truth
truthful	JJ	truthful	NN	truthful
truthfulness	NN	truthfulness
try	VV0	try
trying	VV0	try
tune	NN	tune
tunnel	NN	tunnel
turn	NN	turn	VV0	turn
turned	VV0	turn	VVD	turn
turning	NN	turning	VV0	turn
turnout	NN	turnout
turns	NNS	turn
TV	NN	tv
twinkling	NN	twinkling
two	CD	two
unable	JJ	unable
unanimous	JJ	unanimous
unavailable	JJ	unavailable
unaware	JJ	unaware	NN	unaware
unbearable	JJ	unbearable
unbelievable	JJ	unbelievable
uncertain	JJ	uncertain
uncertainty	NN	uncertainty
unclean	JJ	unclean
unclear	JJ	unclear
uncomfortable	JJ	uncomfortable
unconvincing	VV0	unconvincing
uncovered	VVD	uncover
undeniable	JJ	undeniable
under	IN	under
undercover	RB	undercover
underestimated	VV0	underestimate
understand	NN	understand	VV0	understand
understandable	JJ	understandable
understandably	RB	understandably
understanding	NN	understanding	VV0	understand
understood	VV0	understand	VVD	understand
unease	NN	unease
uneasy	JJ	uneasy
uneven	RB	uneven
unexpected	JJ	unexpected	VVD	unexpected
unfair	JJ	unfair
unfamiliar	JJ	unfamiliar
unforgettable	JJ	unforgettable
unfounded	JJ	unfounded
unharmed	JJ	unharmed
uniformly	RB	uniformly
uninteresting	VV0	uninteresting
unique	JJ	unique
unjust	JJ	unjust
unlikely	JJ	unlikely
unmanageable	JJ	unmanageable
unnecessary	JJ	unnecessary
unnerved	VVD	unnerve
unorganized	VVD	unorganized
unrealistic	JJ	unrealistic
unreasonable	JJ	unreasonable
unsafe	JJ	unsafe
unsettled	JJ	unsettled	VVD	unsettle
unsure	JJ	unsure	NN	unsure
untidy	NN	untidy
until	IN	until
untrue	JJ	untrue
untrustworthy	JJ	untrustworthy
untruthful	JJ	untruthful
unusual	JJ	unusual
up	IN	up	RB	up	RP	up
upbeat	JJ	upbeat
update	JJ	update
updated	JJ	updated	VV0	update
updates	VV0	update
upgrade	NN	upgrade
upgraded	VVD	upgrade
upheld	JJ	upheld
uplifting	VV0	uplift
upon	IN	upon
uproar	NN	uproar
upscale	JJ	upscale
upset	IN	upset	VV0	upset	VVD	upset
upstairs	NNS	upstairs
urged	VVD	urge
urgent	JJ	urgent
urgently	RB	urgently
us	PRP	u
use	VV0	use
used	VV0	use	VVD	use
useless	JJ	useless
uses	VV0	use
using	VV0	use
usual	JJ	usual
usually	RB	usually
utmost	JJ	utmost
vacation	NN	vacation
vaccines	NNS	vaccine
vain	NN	vain
valid	JJ	valid
validated	VVD	validate
validation	NN	validation
valley	NN	valley
valuable	JJ	valuable
value	NN	value
valued	VVD	value
van	NN	van	VV0	van
ve	JJ	ve	NN	ve	NNS	ve	RB	ve
vehicle	NN	vehicle
venture	NN	venture
venue	NN	venue
verdict	NN	verdict
verification	NN	verification
verified	VVD	verify
very	RB	very
viable	JJ	viable	NN	viable
vibrant	JJ	vibrant	NN	vibrant
vibration	NN	vibration
victorious	JJ	victorious
victory	NN	victory
videos	NNS	video
view	NN	view
viewpoint	NN	viewpoint
views	NNS	view
vigorous	JJ	vigorous
village	NN	village
vintage	NN	vintage
violated	VVD	violate
viral	JJ	viral
visit	VV0	visit
visited	VV0	visit	VVD	visit
visiting	VV0	visit
visual	JJ	visual
visually	RB	visually
vital	JJ	vital
vivid	NN	vivid
voice	NN	voice
voiced	VVD	voice
vote	NN	vote
voters	NNS	voter
vowed	VVD	vow
wait	NN	wait	VV0	wait
waiting	VV0	wait
waits	NNS	wait
walk	NN	walk
walked	VVD	walk
walking	JJ	walking	VV0	walk
wall	NN	wall
wallet	NN	wallet
wanted	VVD	want
wanting	VV0	want
warm	JJ	warm	NN	warm	VVD	warm
warmed	VVD	warm
warmth	NN	warmth
warned	VVD	warn
warning	NN	warning
was	VVD	be
wasn	IN	wasn	JJ	wasn	NN	wasn	VV0	wasn	VVD	wasn
waste	JJ	waste	NN	waste
wasted	VV0	waste
watch	NN	watch	VV0	watch
Watch	VV0	watch
watched	VV0	watch	VVD	watch
watching	VV0	watch
water	NN	water
watered	VVD	water
way	NN	way
We	PRP	we
we	PRP	we
weak	JJ	weak
weaknesses	NNS	weakness
wealth	NN	wealth
wear	IN	wear	NN	wear
wearing	NN	wearing	VV0	wear
wears	VV0	wear
weather	NN	weather
wedding	NN	wedding
week	NN	week
weekend	NN	weekend
weekends	NNS	weekend
weeks	NNS	week
weighed	VV0	weigh	VVD	weigh
weird	JJ	weird
welcomed	VV0	welcome	VVD	welcome
well	RB	well
well-acted	JJ	well-acted
well-supported	JJ	well-supported
well‑kept	JJ	well‑kept
well‑known	JJ	well‑known
well‑maintained	VV0	well‑maintained
went	VVD	go
were	VVD	be
weren	NN	weren	VV0	weren
what	PRP	what
wheel	NN	wheel
when	RB	when
where	RB	where
whether	IN	whether
while	IN	while	NN	while
whined	VVD	whine
whining	VV0	whine
whiteboard	NN	whiteboard
who	PRP	who
Who	PRP	who
why	RB	why
wide	JJ	wide
widely	RB	widely
wildlife	NN	wildlife
will	MD	will
Will	MD	will
win	VV0	win
wind	NN	wind
winding	VV0	wind
window	NN	window	VV0	window
winds	VV0	wind
wine	NN	wine
winning	VV0	win
wins	NNS	win
winter	NN	winter
wiped	VV0	wipe
wire	NN	wire
wisdom	NN	wisdom
wise	NN	wise
wish	VV0	wish
wished	VV0	wish	VVD	wish
wishes	NNS	wish
wishing	VV0	wish
with	IN	with
within	IN	within
without	IN	without
witnessed	VVD	witness
wolf	NN	wolf
woman	NN	woman
won	VV0	win	VVD	win
wonder	VV0	wonder
wondered	VVD	wonder
wonderful	JJ	wonderful
woodland	NN	woodland
woods	NNS	wood
word	NN	word
words	NNS	word
wore	VVD	wear
work	NN	work	VV0	work
worked	VVD	work
workforce	NN	workforce
working	VV0	work
workout	NN	workout
works	NNS	work	VV0	work
workshop	NN	workshop
workspace	NN	workspace
worn	VV0	wear
worried	JJ	worried	VVD	worry
worries	NNS	worry
worry	NN	worry
worsen	VV0	worsen
worsened	VVD	worsen
would	MD	would
wouldn	NN	wouldn	VV0	wouldn	VVD	wouldn
wrap	NN	wrap	VV0	wrap
wrench	NN	wrench
wrestled	VVD	wrestle
wrist	NN	wrist
written	VV0	write
wrong	JJ	wrong
wrongly	RB	wrongly
wrote	VVD	write
year	NN	year
years	NNS	year
yes	NNS	yes
yesterday	NN	yesterday
you	PRP	you
younger	JJ	young
youngster	NN	youngster
youngsters	NNS	youngster
your	PRP	your
zoo	NN	zoo
’	CC	’	JJ	’	MD	’	NN	’	VV0	’	VVD	’
.	SENT	.
